11111111111111111111111111111111
1C01C001111111110001111011110011
100100000100000011111C00000001C1
10010000001000001011111000001001
10010111111111110000100011111001
10010011111111111011111011111001
100010111100000000000C0000000001
1000000C000001100000000000C00001
10111111100000E10PCCCCC100000001
10010011000001100000000000000001
1001000000000000011111000C000001
1111000C111100000000000000000001
10010011111111111000000011000001
10000011000110011011100000000001
111111111111111110111111111C1111
10010000C00000000000000100000001
10010000111001111110000000110C01
11111111111111111111111111111111